09,07,07,07,07,07,07,07,07,07,07,12
08,01,01,01,01,01,01,01,01,01,01,08
08,01,01,01,01,01,01,01,01,01,01,08
08,01,01,01,01,01,01,01,01,01,01,08
08,01,01,01,01,01,01,01,01,01,01,08
08,01,01,01,01,01,01,01,01,01,01,08
08,01,01,01,01,01,01,01,01,01,01,08
08,01,01,01,01,01,01,01,01,01,01,08
08,01,01,01,01,01,01,01,01,01,01,08
08,01,01,01,01,01,01,01,01,01,01,08
08,01,01,01,01,01,01,01,01,01,01,08
10,07,07,07,07,07,07,07,07,07,07,11
